; 東方模倣風(r39u1) - stage_9 (phantasm stage)
;---------------------------
; 暫定フォーマットは readme_standard.txt 参照。
0010,3,,,,,,,0128,,,0

; 0240,0,02 1,016,0,240,10,000,512,030,8,30
; 4番目: 速度(負数は逆方向へ移動) [正数右移動→] [負数左移動←] [速度==256 は 1/60秒で1 ドット移動する速さ]
; 5番目: 出現Y座標

;[青-妖精群、前半](ミックスなので単体ではぬるく)

0240,0,014,016,0,-30,010,256,240,030,8,30
0300,0,014,016,0,360,160,768,290,030,8,30
0360,0,014,016,0,-30,040,256,250,030,8,30
0420,0,014,016,0,360,130,768,280,030,8,30
                         
0480,0,014,016,0,-30,070,256,260,030,8,30
0540,0,014,016,0,360,100,768,270,030,8,30
0600,0,014,016,0,-30,100,256,270,030,8,30
0660,0,014,016,0,360,070,768,260,030,8,30
                         
0720,0,014,016,0,-30,130,256,280,030,8,30
0780,0,014,016,0,360,040,768,250,030,8,30
0840,0,014,016,0,-30,160,256,290,030,8,30
0900,0,014,016,0,360,010,768,240,030,8,30

;[青-妖精群、後半](後半の方が若干速度が速い)

0960,0,014,016,0,-30,010,256,300,030,8,30
1020,0,014,016,0,360,160,768,350,030,8,30
1080,0,014,016,0,-30,040,256,310,030,8,30
1140,0,014,016,0,360,130,768,340,030,8,30
                         
1200,0,014,016,0,-30,070,256,320,030,8,30
1260,0,014,016,0,360,100,768,330,030,8,30
1320,0,014,016,0,-30,100,256,330,030,8,30
1380,0,014,016,0,360,070,768,320,030,8,30
                         
1440,0,014,016,0,-30,130,256,340,030,8,30
1500,0,014,016,0,360,040,768,310,030,8,30
1560,0,014,016,0,-30,160,256,350,030,8,30
1620,0,014,016,0,360,010,768,300,030,8,30

; 0600,1,1,000,7,16,50,000,512,1856,14,10000
; //2番目: 弾幕種類+a(番号は仮です。) 
; //4番目: 出現X座標
; //5番目: 出現Y座標

;[ミックス](青-妖精群だけでは単調なので、中ボスを混ぜる)
; 毛玉ラッシュが左側から始まるので接続を考えて配置

; 弾幕種類(番号は仮です。開発が進むと残念ながら番号が変わりますのでDATにメモっておきます) 
; 弾幕種類(メモ)
; 5,	拡散型全方位ナイフ弾	danmaku_create_05_32way_dual
; 7,	拡散型全方位ナイフ弾	danmaku_create_07_80way_dual_five

;	/* (37==32+5) 8:紅1面ボス ルーミア 夜符「ナイトバード」にちょっとだけ似た弾幕(予定) */
;	/* (38==32+6) 8:紅1面ボス ルーミア 夜符「ナイトバード」にちょっとだけ似た弾幕(予定) */
;	/* (39==32+7) 8:紅1面ボス ルーミア 夜符「ナイトバード」にちょっとだけ似た弾幕(予定) */

; 小悪魔
3000,1,0,000,7,150,50,000,512,1856,15,10000

;

; 4面 毛玉ラッシュもどき(あんま似てない)

; 1800,0,011,047,0,速度(負数の場合は逆方向へ移動),Y座標(負数の場合はX座標),000,512,030,8,30
; //2番目: 0:紅っぽい毛玉(狭角度 奇数弾) 1:妖っぽい毛玉(90度 4方向) (無駄弾なので難易度は低い筈)
; //4番目: 速度(負数は逆方向へ移動) [正数右移動→] [負数左移動←] [速度==256 は 1/60秒で1 ドット移動する速さ]
; //5番目: 出現Y座標(負数の場合は出現X座標)

; 下移動([1]左 [2]中)
1800,0,011,047,0,320,-088,000,512,080,8,70
1816,0,011,047,0,320,-088,000,512,080,8,70
1832,0,011,047,0,320,-088,000,512,080,8,70
1848,0,011,047,0,320,-088,000,512,080,8,70
1864,0,011,047,0,320,-088,000,512,080,8,70
1880,0,011,047,0,320,-088,000,512,080,8,70
1950,0,011,047,0,320,-176,000,512,080,8,70
1966,0,011,047,0,320,-176,000,512,080,8,70
1982,0,011,047,0,320,-176,000,512,080,8,70
1998,0,011,047,0,320,-176,000,512,080,8,70
2014,0,011,047,0,320,-176,000,512,080,8,70
2030,0,011,047,0,320,-176,000,512,080,8,70

; 横移動([3]左中 [4]右下)
2100,0,011,047,0,0414,64,000,512,080,8,70
2116,0,011,047,0,0414,64,000,512,080,8,70
2132,0,011,047,0,0414,64,000,512,080,8,70
2148,0,011,047,0,0414,64,000,512,080,8,70
2164,0,011,047,0,0414,64,000,512,080,8,70
2180,0,011,047,0,0414,64,000,512,080,8,70
2250,0,011,047,0,-414,96,000,512,080,8,70
2266,0,011,047,0,-414,96,000,512,080,8,70
2282,0,011,047,0,-414,96,000,512,080,8,70
2298,0,011,047,0,-414,96,000,512,080,8,70
2314,0,011,047,0,-414,96,000,512,080,8,70
2330,0,011,047,0,-414,96,000,512,080,8,70

; 下移動([5]右 [6]中)
2400,0,011,047,0,320,-264,000,512,080,8,70
2416,0,011,047,0,320,-264,000,512,080,8,70
2432,0,011,047,0,320,-264,000,512,080,8,70
2448,0,011,047,0,320,-264,000,512,080,8,70
2464,0,011,047,0,320,-264,000,512,080,8,70
2480,0,011,047,0,320,-264,000,512,080,8,70
2550,0,011,047,0,320,-176,000,512,080,8,70
2566,0,011,047,0,320,-176,000,512,080,8,70
2582,0,011,047,0,320,-176,000,512,080,8,70
2598,0,011,047,0,320,-176,000,512,080,8,70
2614,0,011,047,0,320,-176,000,512,080,8,70
2630,0,011,047,0,320,-176,000,512,080,8,70

; 横移動([7]右上 [8]左中)
2700,0,011,047,0,-414,32,000,512,080,8,70
2716,0,011,047,0,-414,32,000,512,080,8,70
2732,0,011,047,0,-414,32,000,512,080,8,70
2748,0,011,047,0,-414,32,000,512,080,8,70
2764,0,011,047,0,-414,32,000,512,080,8,70
2780,0,011,047,0,-414,32,000,512,080,8,70
2850,0,011,047,0,0414,64,000,512,080,8,70
2866,0,011,047,0,0414,64,000,512,080,8,70
2882,0,011,047,0,0414,64,000,512,080,8,70
2898,0,011,047,0,0414,64,000,512,080,8,70
2914,0,011,047,0,0414,64,000,512,080,8,70
2930,0,011,047,0,0414,64,000,512,080,8,70

; ボス 7 - ？ - 
3600,3,,,,,,,0000,,,0
3600,2,7,,,192,-100,000,000,,,10000
