; 東方模倣風(r39u1) - stage_1
;---------------------------
; 暫定フォーマットは readme_standard.txt 参照。
0010,3,,,,,,,0128,,,0

; 0x50==080 から16フレームずつ 0x10=16
; 左妖精群1 [妖精1-青妖精-右向き016,017,018,019]
0280,0,019,016,0,048,-100,000,512,005,8,30
0296,0,019,016,0,068,-100,000,512,005,8,30
0312,0,019,016,0,048,-080,000,512,010,8,30
0328,0,019,016,0,068,-080,000,512,005,8,30
0344,0,019,016,0,048,-060,000,512,005,8,30
0360,0,019,016,0,068,-060,000,512,005,8,30
0376,0,019,016,0,048,-040,000,512,010,8,30
0392,0,019,016,0,068,-040,000,512,005,8,30

; 右妖精群2 [妖精1-青妖精-左向き024,025,026,027]
0456,0,019,024,0,304,-100,000,512,010,8,30
0472,0,019,024,0,324,-100,000,512,005,8,30
0488,0,019,024,0,304,-080,000,512,010,8,30
0504,0,019,024,0,324,-080,000,512,010,8,30
0520,0,019,024,0,304,-060,000,512,030,8,30
0536,0,019,024,0,324,-060,000,512,010,8,30
0552,0,019,024,0,304,-040,000,512,005,8,30
0568,0,019,024,0,324,-040,000,512,010,8,30

;; 妖精群3[左→右]
; [妖精1-青妖精-右向き016,017,018,019]
0632,0,019,016,0,048,-100,000,512,010,8,30
0632,0,019,016,0,068,-100,000,512,010,8,30
0648,0,019,016,0,048,-080,000,512,010,8,30
0648,0,019,016,0,068,-080,000,512,010,8,30
;
0664,0,019,016,0,112,-080,000,512,010,8,30
0664,0,019,016,0,132,-080,000,512,010,8,30
0680,0,019,016,0,112,-060,000,512,010,8,30
0680,0,019,016,0,132,-060,000,512,010,8,30
; [妖精1-青妖精-正面向き020,021,022,023]
0696,0,019,020,0,176,-060,000,512,030,8,30
0696,0,019,020,0,196,-060,000,512,030,8,30
0712,0,019,020,0,176,-040,000,512,030,8,30
0712,0,019,020,0,196,-040,000,512,030,8,30
; [妖精1-青妖精-左向き024,025,026,027]
0728,0,019,024,0,240,-080,000,512,010,8,30
0728,0,019,024,0,260,-080,000,512,010,8,30
0744,0,019,024,0,240,-060,000,512,010,8,30
0744,0,019,024,0,260,-060,000,512,010,8,30
;
0760,0,019,024,0,304,-100,000,512,010,8,30
0760,0,019,024,0,324,-100,000,512,010,8,30
0776,0,019,024,0,304,-080,000,512,010,8,30
0776,0,019,024,0,324,-080,000,512,010,8,30

; 0x240==576 
; 64 フレーム休み(0x40==0x280-0x240)
; 0x280==640 

; -240

; [妖精3-赤妖精-正面向き052,053,054,055]
; "ひやかし(倒せない)"	/* 3番目:1:"妖怪2"(赤) */	/* 5番目:0:弾幕生成しない */
0800,1,1,052,0,186,50,000,512,1856,14,10
; [妖精2-黄妖精-正面向き036,037,038,039]
0860,0,015,036,0,064,-32,000,000,020,0,70
0880,0,015,036,0,096,-32,000,000,020,0,70
0940,0,015,036,0,176,-32,000,000,005,0,70
0960,0,015,036,0,256,-32,000,000,020,0,70
0980,0,015,036,0,336,-32,000,000,020,0,70
; [妖精1-青妖精-正面向き020,021,022,023]
1000,0,006,020,0,106,-30,000,424,010,0,30
1030,0,006,020,0,306,-30,000,424,010,0,30
1060,0,006,020,0,106,-30,000,424,010,0,30
1090,0,006,020,0,306,-30,000,424,030,0,30
1100,0,006,020,0,106,-30,000,424,010,0,30
1130,0,006,020,0,306,-30,000,424,010,0,30
1160,0,006,020,0,106,-30,000,424,005,0,30
1190,0,006,020,0,306,-30,000,424,010,0,30
; [妖精3-赤妖精-正面向き052,053,054,055]
1220,0,013,052,0,196,-30,000,512,003,8,30
1240,0,013,052,0,196,-30,000,512,003,8,30
1260,0,013,052,0,196,-30,000,512,003,8,30
1280,0,013,052,0,196,-30,000,512,003,8,30
;
1320,0,013,052,0,196,-30,000,512,003,8,30
1340,0,013,052,0,196,-30,000,512,003,8,30
1360,0,013,052,0,196,-30,000,512,003,8,30
1380,0,013,052,0,196,-30,000,512,003,8,30
;
; "ひやかし(倒せない)"	/* 0:弾幕生成しない */
1390,1,1,052,0,086,50,000,512,1856,14,10
; [妖精2-黄妖精-正面向き036,037,038,039]
1400,0,019,036,0,048,-064,000,512,010,8,30
1460,0,019,036,0,176,-064,000,512,010,8,30
1520,0,019,036,0,112,-064,000,512,010,8,30
1580,0,019,036,0,240,-064,000,512,010,8,30
1640,0,019,036,0,216,-064,000,512,010,8,30
1760,0,019,036,0,048,-048,000,512,010,8,30
1760,0,019,036,0,318,-048,000,512,010,8,30
1790,0,019,036,0,048,-048,000,512,010,8,30
1790,0,019,036,0,318,-048,000,512,040,8,30
1820,0,019,036,0,048,-048,000,512,010,8,30
1820,0,019,036,0,318,-048,000,512,010,8,30
1850,0,019,036,0,048,-048,000,512,010,8,30
1850,0,019,036,0,318,-048,000,512,010,8,30
1880,0,019,036,0,048,-048,000,512,010,8,30
1880,0,019,036,0,318,-032,000,512,010,8,30
1930,0,019,036,0,288,-032,000,512,010,8,30
1960,0,019,036,0,258,-032,000,512,010,8,30
1990,0,019,036,0,228,-032,000,512,010,8,30
2020,0,019,036,0,198,-032,000,512,010,8,30
2050,0,019,036,0,168,-032,000,512,050,8,30
2080,0,019,036,0,138,-032,000,512,005,8,30
2110,0,019,036,0,108,-032,000,512,010,8,30
2140,0,019,036,0,078,-032,000,512,010,8,30

;-640

; "ルーミア"	/* 8:紅1面ボス ルーミア 夜符「ナイトバード」にちょっとだけ似た弾幕(予定) */
2590,1,0,000,8,186,50,000,512,1856,15,3000
;+340隠し中ボス(早回しのみ出現)
2930,1,3,048,6,175,50,000,512,1856,14,6000
;
2600,0,015,032,0,056,-32,000,000,030,8,70
2600,0,015,032,0,136,-32,000,000,030,8,70
2600,0,015,032,0,216,-32,000,000,030,8,70
2600,0,015,032,0,296,-32,000,000,030,8,70
;
2660,0,006,036,0,106,-30,000,424,010,8,30
2660,0,006,036,0,306,-30,000,424,010,8,30
2780,0,006,036,0,106,-30,000,424,010,8,30
2780,0,006,036,0,306,-30,000,424,010,8,30
2900,0,006,036,0,106,-30,000,424,010,8,30
2900,0,006,036,0,306,-30,000,424,010,8,30
2960,0,019,016,0,064,-016,000,512,010,8,30
2960,0,019,016,0,048,-016,000,512,010,8,30
3020,0,019,016,0,080,-016,000,512,010,8,30
3020,0,019,016,0,304,-016,000,512,010,8,30
3080,0,019,016,0,112,-016,000,512,010,8,30
3080,0,019,016,0,272,-016,000,512,010,8,30
3140,0,019,016,0,144,-016,000,512,010,8,30
3140,0,019,016,0,240,-016,000,512,005,8,30
3200,0,019,016,0,176,-016,000,512,010,8,30
3200,0,019,016,0,208,-016,000,512,010,8,30
;
3320,0,009,062,0,048,-16,000,512,090,8,70
3320,0,009,062,0,064,-32,000,512,080,8,70
3320,0,009,062,0,080,-48,000,512,170,8,70
;
3320,0,009,062,0,112,-64,000,512,160,8,70
3320,0,009,062,0,144,-48,000,512,050,8,70
3320,0,009,062,0,176,-32,000,512,040,8,70
;
3320,0,009,062,0,208,-16,000,512,030,8,70
3320,0,009,062,0,240,-32,000,512,120,8,70
3320,0,009,062,0,272,-64,000,512,010,8,70
;
;3380,赤 毛 玉2,0,0,0,,1,000,512,030,8,10-------(r32)????
3500,0,006,036,0,106,-30,000,424,010,8,30
3500,0,006,036,0,306,-30,000,424,010,8,30
3530,0,006,036,0,106,-30,000,424,010,8,30
3530,0,006,036,0,306,-30,000,424,010,8,30
3560,0,006,036,0,106,-30,000,424,010,8,30
3560,0,006,036,0,306,-30,000,424,010,8,30
3590,0,006,036,0,106,-30,000,424,010,8,30
3590,0,006,036,0,306,-30,000,424,010,8,30
;
3620,0,015,020,0,048,-32,000,000,030,8,70
3620,0,015,020,0,056,-32,000,000,030,8,70
3620,0,015,020,0,096,-32,000,000,030,8,70
3620,0,015,020,0,136,-32,000,000,030,8,70
3620,0,015,020,0,176,-32,000,000,005,8,70
3620,0,015,020,0,216,-32,000,000,050,8,70
3620,0,015,020,0,256,-32,000,000,050,8,70
3620,0,015,020,0,296,-32,000,000,050,8,70
3620,0,015,020,0,336,-32,000,000,050,8,70
;
3700,0,006,036,0,106,-30,000,424,010,8,30
3700,0,006,036,0,306,-30,000,424,010,8,30
3730,0,006,036,0,106,-30,000,424,010,8,30
3730,0,006,036,0,306,-30,000,424,010,8,30
3760,0,006,036,0,106,-30,000,424,010,8,30
3760,0,006,036,0,306,-30,000,424,010,8,30
3790,0,006,036,0,106,-30,000,424,010,8,30
3790,0,006,036,0,306,-30,000,424,010,8,30
; "雑魚中ボス"	/* 3番目:1:"妖怪2"(赤) */	/* 5番目:8:紅1面ボス ルーミア 夜符「ナイトバード」にちょっとだけ似た弾幕(予定) */
4090,1,1,020,8,286,050,000,512,1856,14,3000
;+330隠し中ボス(早回しのみ出現)
4420,1,2,052,6,175,50,000,512,1856,14,6000
;
4100,0,007,061,0,048,-30,1024,688,010,8,30
4105,0,007,061,0,048,-30,1024,688,005,8,30
4110,0,007,061,0,048,-30,1024,688,010,8,30
;
4115,0,007,062,0,336,-30,1024,688,010,8,30
4120,0,007,062,0,336,-30,1024,688,010,8,30
4220,0,007,062,0,336,-30,1024,688,010,8,30
4225,0,007,062,0,336,-30,1024,688,010,8,30
;
4230,0,007,062,0,048,-30,1024,688,010,8,30
4235,0,007,062,0,048,-30,1024,688,010,8,30
4240,0,007,062,0,048,-30,1024,688,010,8,30
;
4300,0,009,062,0,112,-16,000,512,010,8,70
4300,0,009,062,0,144,-32,000,512,020,8,70
4340,0,009,062,0,176,-48,000,512,130,8,70
4340,0,009,062,0,208,-64,000,512,140,8,70
4380,0,009,062,0,240,-48,000,512,050,8,70
4380,0,009,062,0,272,-32,000,512,060,8,70
4400,0,009,062,0,304,-32,000,512,080,8,70
4400,0,009,062,0,336,-64,000,512,190,8,70
;
4500,0,006,062,0,048,1,065,256,005,8,30
4500,0,006,062,0,064,1,142,333,010,8,30
4520,0,006,062,0,080,1,056,356,010,8,30
4520,0,006,062,0,176,1,110,292,010,8,30
;
4540,0,006,062,0,208,1,987,289,010,8,30
4540,0,006,062,0,240,1,924,357,010,8,30
4580,0,006,062,0,304,1,867,225,010,8,30
4580,0,006,062,0,336,1,915,888,010,8,30
;
4620,0,009,059,0,048,-16,000,512,050,8,70
4620,0,009,059,0,112,-32,000,512,020,8,70
4640,0,009,059,0,144,-16,000,512,010,8,70
4640,0,009,059,0,208,-16,000,512,010,8,70
;
4660,0,009,059,0,240,-32,000,512,020,8,70
4660,0,009,059,0,272,-48,000,512,130,8,70
4680,0,009,059,0,304,-32,000,512,040,8,70
4680,0,009,059,0,336,-16,000,512,150,8,70
;
4740,0,006,062,0,048,1,053,456,010,8,30
4740,0,006,062,0,064,1,122,458,010,8,30
4760,0,006,062,0,080,1,060,584,010,8,30
4760,0,006,062,0,144,1,100,258,010,8,30
;
4780,0,006,060,0,176,1,048,485,010,8,30
4780,0,006,060,0,272,1,966,357,010,8,30
4800,0,006,060,0,304,1,845,369,005,8,30
4800,0,006,060,0,336,1,922,259,010,8,30
;
4860,0,013,052,0,196,-30,000,512,003,8,30
4860,0,013,052,0,196,-30,000,512,005,8,30
4860,0,013,052,0,196,-30,000,512,005,8,30
4860,0,013,052,0,196,-30,000,512,003,8,30
;
4880,0,013,052,0,196,-30,000,512,003,8,30
4880,0,013,052,0,196,-30,000,512,013,8,30
4880,0,013,052,0,196,-30,000,512,005,8,30
4880,0,013,052,0,196,-30,000,512,005,8,30
;
4900,0,013,052,0,196,-30,000,512,005,8,30
4900,0,013,052,0,196,-30,000,512,003,8,30
4920,0,013,052,0,196,-30,000,512,015,8,30
4920,0,013,052,0,196,-30,000,512,005,8,30
;
4980,0,006,062,0,048,1,043,495,010,8,30
4980,0,006,062,0,064,1,155,324,010,8,30
4990,0,006,062,0,080,1,028,384,010,8,30
4990,0,006,062,0,144,1,083,245,005,8,30
;
5000,0,006,062,0,240,1,915,384,010,8,30
5000,0,006,062,0,272,1,984,295,010,8,30
5010,0,006,062,0,304,1,837,645,010,8,30
5010,0,006,062,0,336,1,967,474,005,8,30
;
5020,0,019,020,0,128,-016,000,512,003,8,30
5030,0,019,020,0,048,-016,000,512,030,8,30
5040,0,019,020,0,064,-016,000,512,010,8,30
5050,0,019,020,0,320,-016,000,512,005,8,30
5060,0,019,020,0,080,-016,000,512,010,8,30
5070,0,019,020,0,304,-016,000,512,030,8,30
5080,0,019,020,0,096,-016,000,512,010,8,30
5090,0,019,020,0,286,-016,000,512,010,8,30
5100,0,019,020,0,112,-016,000,512,005,8,30
5110,0,019,020,0,272,-016,000,512,010,8,30
5120,0,019,020,0,130,-016,000,512,030,8,30
5130,0,019,020,0,254,-016,000,512,010,8,30
5140,0,019,020,0,144,-016,000,512,010,8,30
5150,0,019,020,0,240,-016,000,512,030,8,30
5160,0,019,020,0,126,-016,000,512,010,8,30
5170,0,019,020,0,222,-016,000,512,007,8,30
5180,0,019,020,0,176,-016,000,512,030,8,30
5190,0,019,020,0,208,-016,000,512,010,8,30

; ボス 1 - アリス・マーガトロイド - 
5500,3,,,,,,,0000,,,0
5500,2,1,,,192,-100,000,000,,,10000

; 1面の雑魚は基本的に 300ptsか 700ptsしか出てこない。
