; 東方模倣風(r39u1) - stage_4
;---------------------------
; 暫定フォーマットは readme_standard.txt 参照。
0010,3,,,,,,,0128,,,0

0380,0,002,029,1,144,-512,000,512,030,10,50
0380,0,002,029,1,210,-512,000,512,030,10,50
0380,0,002,029,1,080,-512,000,512,030,10,50
0380,0,002,029,1,176,-512,000,512,030,10,50
0380,0,002,029,1,157,-512,000,512,030,10,50
;
0560,0,016,048,0,-32,50,796,0651,050,8,50
0560,0,016,048,0,352,50,227,0890,050,8,50
0560,0,016,048,0,-32,50,796,0434,050,8,50
0560,0,016,048,0,352,50,227,0839,050,8,50
;
0600,0,002,029,0,048,-512,000,512,030,10,50
0600,0,002,029,0,304,-512,000,512,030,10,50
0600,0,002,029,0,163,-512,000,512,030,10,50
0600,0,002,029,0,094,-512,000,512,030,10,50
0600,0,002,029,0,227,-512,000,512,030,10,50
;
0680,0,016,048,0,-32,50,796,0124,060,8,50
0680,0,016,048,0,352,50,227,0362,060,8,50
0680,0,016,048,0,-32,50,796,0299,060,8,60
0680,0,016,048,0,352,50,227,0502,060,8,50
;
0700,0,009,060,0,208,-16,000,512,110,8,200
0700,0,009,060,0,240,-32,000,512,120,8,200
0700,0,009,060,0,272,-48,000,512,130,8,200
0700,0,009,060,0,304,-32,000,512,140,8,200
0700,0,009,060,0,336,-16,000,512,150,8,200
;
0800,0,002,029,2,105,-512,000,512,030,10,50
0800,0,002,029,2,200,-512,000,512,030,10,50
0800,0,002,029,2,091,-512,000,512,030,10,50
0800,0,002,029,2,066,-512,000,512,030,10,50
0800,0,002,029,2,175,-512,000,512,030,10,50
;
0900,0,002,029,3,227,-512,000,512,030,10,50
0900,0,002,029,3,154,-512,000,512,030,10,50
0900,0,002,029,3,110,-512,000,512,030,10,50
0900,0,002,029,3,153,-512,000,512,030,10,50
0900,0,002,029,3,160,-512,000,512,030,10,50
;
1080,0,006,036,0,106,-30,000,424,030,8,50
1080,0,006,036,0,306,-30,000,424,030,8,50
1200,3,,,,,,,0179,,,0
;
1380,0,009,060,0,016,-16,000,512,150,8,200
1380,0,009,060,0,048,-32,000,512,140,8,200
1380,0,009,060,0,080,-48,000,512,130,8,200
1380,0,009,060,0,112,-32,000,512,120,8,200
1380,0,009,060,0,144,-16,000,512,110,8,200

;----------
1560,0,016,048,0,-32,50,796,0432,050,8,50
1560,0,016,048,0,352,50,227,0854,050,8,50
1560,0,016,048,0,-32,50,796,0218,050,8,50
1560,0,016,048,0,352,50,227,0158,050,8,50
;
1560,0,016,048,0,-32,50,796,0415,050,8,50
1560,0,016,048,0,352,50,227,0082,050,8,50
1560,0,016,048,0,-32,50,796,0984,050,8,50
1560,0,016,048,0,352,50,227,0472,050,8,50
;
1680,0,016,048,0,-32,50,796,0211,060,8,50
1680,0,016,048,0,352,50,227,0504,060,8,50
1680,0,016,048,0,-32,50,796,0391,060,8,50
1680,0,016,048,0,352,50,227,0605,060,8,50
;
1680,0,016,048,0,-32,50,796,0395,060,8,50
1680,0,016,048,0,352,50,227,0432,060,8,50
1680,0,016,048,0,-32,50,796,0821,060,8,50
1680,0,016,048,0,352,50,227,0158,060,8,50
;---------- ",0,005," == キスメ
1700,0,005,044,0,326,-30,000,384,272,8,200
1720,0,005,044,0,326,-30,000,384,272,8,200
1740,0,005,044,0,326,-30,000,384,272,8,200
1760,0,005,044,0,326,-30,000,384,272,8,200
1780,0,005,044,0,326,-30,000,384,272,8,200
1800,0,005,044,0,326,-30,000,384,272,8,200
1820,0,005,044,0,326,-30,000,384,272,8,200
1840,0,005,044,0,326,-30,000,384,272,8,200
1860,0,005,044,0,326,-30,000,384,272,8,200
1880,0,005,044,0,326,-30,000,384,272,8,200
1900,0,005,044,0,326,-30,000,384,272,8,200
1920,0,005,044,0,326,-30,000,384,272,8,200
1940,0,005,044,0,326,-30,000,384,272,8,200
1960,0,005,044,0,326,-30,000,384,272,8,200
1980,0,005,044,0,326,-30,000,384,272,8,200
;----------
2040,0,017,048,0,010,010,796,384,300,8,50
2050,0,017,048,0,350,010,227,384,310,8,50
2060,0,017,048,0,010,010,796,384,320,8,50
2070,0,017,048,0,350,010,227,384,330,8,50
;
2080,0,017,048,0,010,010,796,384,340,8,50
2090,0,017,048,0,350,010,227,384,350,8,50
2100,0,017,048,0,010,010,796,384,360,8,50
2110,0,017,048,0,350,010,227,384,370,8,50
;
2120,0,017,048,0,010,010,796,384,380,8,50
2130,0,017,048,0,350,010,227,384,390,8,50
;
2140,0,017,048,0,010,010,796,384,400,8,50
2150,0,017,048,0,350,010,227,384,410,8,50
2160,0,017,048,0,010,010,796,384,420,8,50
2170,0,017,048,0,350,010,227,384,430,8,50
;
2180,0,017,048,0,010,010,796,384,440,8,50
2190,0,017,048,0,350,010,227,384,450,8,50
2200,0,017,048,0,010,010,796,384,460,8,50
2210,0,017,048,0,350,010,227,384,470,8,50
;
2220,0,017,048,0,010,010,796,384,480,8,50
2230,0,017,048,0,350,010,227,384,490,8,50
;
2280,0,015,048,0,016,-32,000,000,070,8,200
2280,0,015,048,0,056,-32,000,000,070,8,200
2280,0,015,048,0,096,-32,000,000,070,8,200
2280,0,015,048,0,136,-32,000,000,070,8,200
2280,0,015,048,0,176,-32,000,000,070,8,200
2280,0,015,048,0,216,-32,000,000,070,8,200
2280,0,015,048,0,256,-32,000,000,070,8,200
2280,0,015,048,0,296,-32,000,000,070,8,200
2280,0,015,048,0,336,-32,000,000,070,8,200
;
2400,3,,,,,,,0230,,,0
;---------- ",1,0," == 犬走 椛, 30==ののじ弾幕(仮)
;2640,1,0,000,30,200,50,000,512,1856,15,10000; (HP:1856, ITEM:15==(旧ルーミア互換仕様) 数値:1万(==10万pts). [r34])
; ( 弾幕種類:30==ののじっぽい弾幕(仮), HP:18560, ITEM:3==(1up) 数値:1万(==10万pts). [r35])
;2640,1,0,000,30,200,50,000,512,18560,3,10000
2640,1,0,000,30,200,50,000,512,8888,3,10000

;2640,1,1,016,6,16,50,000,512,1856,14,10000
;+340隠し中ボス(早回しのみ出現)張り付くか、ボムれば簡単に出る。
2980,1,3,048,6,175,50,000,512,1856,14,6000
;+350隠し中ボス(早回しのみ出現)隠しでなく普通に出る。
; 隠しでない感じ 2990,1,3,048,6,175,50,000,512,1856,14,6000

2700,3,,,,,,,0768,,,0
;囲-妖-怪1 x座標は1周を1024分割した角度(0-1023)
;[16分割]
2880,0,004,030,0,192,136,000,350,030,8,50
2880,0,004,030,0,192,136,064,350,030,8,50
2880,0,004,030,0,192,136,128,350,030,8,50
2880,0,004,030,0,192,136,192,350,030,8,50
2880,0,004,030,0,192,136,256,350,030,8,50
2880,0,004,030,0,192,136,320,350,030,8,50
2880,0,004,030,0,192,136,384,350,030,8,50
2880,0,004,030,0,192,136,448,350,030,8,50
2880,0,004,030,0,192,136,512,350,030,8,50
2880,0,004,030,0,192,136,576,350,030,8,50
2880,0,004,030,0,192,136,640,350,030,8,50
2880,0,004,030,0,192,136,704,350,030,8,50
2880,0,004,030,0,192,136,768,350,030,8,50
2880,0,004,030,0,192,136,832,350,030,8,50
2880,0,004,030,0,192,136,896,350,030,8,50
2880,0,004,030,0,192,136,960,350,030,8,50

;ザコ020#0#9#1#8#2#7謎メモ
3020,0,012,016,0,372,100,000,512,200,8,200
3020,0,012,016,0,-60,100,000,512,200,8,200
3040,0,012,016,0,392,070,000,512,200,8,200
3040,0,012,016,0,-40,070,000,512,200,8,200
3080,0,012,016,0,412,040,000,512,200,8,200
3080,0,012,016,0,-20,040,000,512,200,8,200
;
3120,0,008,060,0,144,-50,000,640,300,8,200
3120,0,008,060,0,231,-50,000,640,300,8,200
3120,0,008,060,0,212,-50,000,640,300,8,200
;ザコ020#3#6謎メモ
3180,0,012,016,0,-30,-300,000,512,200,8,50
3180,0,012,016,0,-30,-080,000,512,200,8,50
3240,0,006,036,0,106,-030,000,424,030,8,50
3240,0,006,036,0,306,-030,000,424,030,8,50
;ザコ020#0#9謎メモ
3300,0,012,016,0,372,0100,000,512,200,8,50
3300,0,012,016,0,-60,0100,000,512,200,8,50
;
3360,0,008,060,0,028,-50,000,640,400,8,200
3360,0,008,060,0,191,-50,000,640,400,8,200
3360,0,008,060,0,111,-50,000,640,400,8,200

3400,0,008,060,0,080,-50,000,640,500,8,200
3400,0,008,060,0,227,-50,000,640,500,8,200
3400,0,008,060,0,267,-50,000,640,500,8,200

;ザコ020#3#6#4#5謎メモ
3480,0,012,016,0,-30,-300,000,512,200,8,200
3480,0,012,016,0,-30,-080,000,512,200,8,200
3500,0,012,016,0,-50,-220,000,512,200,8,200
3500,0,012,016,0,-50,-160,000,512,200,8,200

; 左側から

;---------- ",1,1," == ザコ天狗(蝶??)
3550,1,1,016,6,175,50,000,512,1856,4,2000
;+330隠し中ボス(早回しのみ出現)張り付くか、ボムれば出る。
3880,1,2,032,6,175,50,000,512,1856,4,6000
;+350隠し中ボス(早回しのみ出現)隠しでなく普通に出る。
; 隠しでない感じ 3900,1,2,032,6,175,50,000,512,1856,4,6000

; #002-陰-陽-玉
4000,0,002,029,0,048,-512,000,512,030,10,50
4000,0,002,029,0,304,-512,000,512,030,10,50
4000,0,002,029,0,163,-512,000,512,030,10,50
4000,0,002,029,0,094,-512,000,512,030,10,50
4000,0,002,029,0,227,-512,000,512,030,10,50
;
4100,0,002,029,1,144,-512,000,512,030,10,50
4100,0,002,029,1,210,-512,000,512,030,10,50
4100,0,002,029,1,080,-512,000,512,030,10,50
4100,0,002,029,1,176,-512,000,512,030,10,50
4100,0,002,029,1,157,-512,000,512,030,10,50
;
4200,0,002,029,2,105,-512,000,512,030,10,50
4200,0,002,029,2,200,-512,000,512,030,10,50
4200,0,002,029,2,091,-512,000,512,030,10,50
4200,0,002,029,2,066,-512,000,512,030,10,50
4200,0,002,029,2,175,-512,000,512,030,10,50
;
4300,0,002,029,3,227,-512,000,512,030,10,50
4300,0,002,029,3,154,-512,000,512,030,10,50
4300,0,002,029,3,110,-512,000,512,030,10,50
4300,0,002,029,3,153,-512,000,512,030,10,50
4300,0,002,029,3,160,-512,000,512,030,10,50
;
4200,3,,,,,,,1024,,,0
;ザコ020#0#9#1#8#2#7謎メモ
4320,0,012,016,0,372,100,000,512,200,8,200
4320,0,012,016,0,-60,100,000,512,200,8,200
4440,0,012,016,0,392,070,000,512,200,8,200
4440,0,012,016,0,-40,070,000,512,200,8,200
4560,0,012,016,0,412,040,000,512,200,8,200
4560,0,012,016,0,-20,040,000,512,200,8,200
;
4560,0,008,060,0,130,-050,000,640,600,8,200
4560,0,008,060,0,201,-050,000,640,600,8,200
4560,0,008,060,0,051,-050,000,640,600,8,200
;ザコ020#3#6#4#5謎メモ
4680,0,012,016,0,-30,-300,000,512,200,8,200
4680,0,012,016,0,-30,-080,000,512,200,8,200
4800,0,012,016,0,-50,-220,000,512,200,8,200
4800,0,012,016,0,-50,-160,000,512,200,8,200
4800,3,,,,,,,0204,,,0
;
4920,0,013,036,0,196,-30,000,512,010,8,50
4920,0,013,036,0,196,-30,000,512,010,8,50
4920,0,013,036,0,196,-30,000,512,010,8,50
4920,0,013,036,0,196,-30,000,512,010,8,50
;
4920,0,013,036,0,196,-30,000,512,010,8,50
4920,0,013,036,0,196,-30,000,512,010,8,50
4920,0,013,036,0,196,-30,000,512,010,8,50
4920,0,013,036,0,196,-30,000,512,010,8,50
;
4920,0,013,036,0,196,-30,000,512,010,8,50
4920,0,013,036,0,196,-30,000,512,010,8,50
4920,0,013,036,0,196,-30,000,512,010,8,50
4920,0,013,036,0,196,-30,000,512,010,8,50
;
4920,0,013,036,0,196,-30,000,512,010,8,50
4920,0,013,036,0,196,-30,000,512,010,8,50
4920,0,013,036,0,196,-30,000,512,010,8,50
4920,0,013,036,0,196,-30,000,512,010,8,50
;

;---------------------------
; 032==カラス[右向き1]→
5040,0,014,032,0,-30,60,256,306,030,8,50
5050,0,014,032,0,-30,60,256,306,030,8,50
5060,0,014,032,0,-30,60,256,306,030,8,50
5070,0,014,032,0,-30,60,256,306,030,8,50
5080,0,014,032,0,-30,60,256,306,030,8,50
5090,0,014,032,0,-30,60,256,306,030,8,50
5100,0,014,032,0,-30,60,256,306,030,8,50
5110,0,014,032,0,-30,60,256,306,030,8,50
 
5120,0,014,032,0,-30,60,256,306,030,8,50
5130,0,014,032,0,-30,60,256,306,030,8,50
5140,0,014,032,0,-30,60,256,306,030,8,50
5150,0,014,032,0,-30,60,256,306,030,8,50
5160,0,014,032,0,-30,60,256,306,030,8,50
5170,0,014,032,0,-30,60,256,306,030,8,50
5180,0,014,032,0,-30,60,256,306,030,8,50
5190,0,014,032,0,-30,60,256,306,030,8,50
 
5200,0,014,032,0,-30,60,256,306,030,8,50
5210,0,014,032,0,-30,60,256,306,030,8,50
5220,0,014,032,0,-30,60,256,306,030,8,50
5230,0,014,032,0,-30,60,256,306,030,8,50
5240,0,014,032,0,-30,60,256,306,030,8,50
5250,0,014,032,0,-30,60,256,306,030,8,50
5260,0,014,032,0,-30,60,256,306,030,8,50
5270,0,014,032,0,-30,60,256,306,030,8,50
 
5280,0,014,032,0,-30,60,256,306,030,8,50
5290,0,014,032,0,-30,60,256,306,030,8,50
5300,0,014,032,0,-30,60,256,306,030,8,50
5310,0,014,032,0,-30,60,256,306,030,8,50
5320,0,014,032,0,-30,60,256,306,030,8,50
5330,0,014,032,0,-30,60,256,306,030,8,50
5340,0,014,032,0,-30,60,256,306,030,8,50
5350,0,014,032,0,-30,60,256,306,030,8,50

;---------------------------
; 040==カラス[左向き1]←
5040,0,014,040,0,360,60,768,306,030,8,50
5050,0,014,040,0,360,60,768,306,030,8,50
5060,0,014,040,0,360,60,768,306,030,8,50
5070,0,014,040,0,360,60,768,306,030,8,50
5080,0,014,040,0,360,60,768,306,030,8,50
5090,0,014,040,0,360,60,768,306,030,8,50
5100,0,014,040,0,360,60,768,306,030,8,50
5110,0,014,040,0,360,60,768,306,030,8,50

5120,0,014,040,0,360,60,768,306,030,8,50
5130,0,014,040,0,360,60,768,306,030,8,50
5140,0,014,040,0,360,60,768,306,030,8,50
5150,0,014,040,0,360,60,768,306,030,8,50
5160,0,014,040,0,360,60,768,306,030,8,50
5170,0,014,040,0,360,60,768,306,030,8,50
5180,0,014,040,0,360,60,768,306,030,8,50
5190,0,014,040,0,360,60,768,306,030,8,50

5200,0,014,040,0,360,60,768,306,030,8,50
5210,0,014,040,0,360,60,768,306,030,8,50
5220,0,014,040,0,360,60,768,306,030,8,50
5230,0,014,040,0,360,60,768,306,030,8,50
5240,0,014,040,0,360,60,768,306,030,8,50
5250,0,014,040,0,360,60,768,306,030,8,50
5260,0,014,040,0,360,60,768,306,030,8,50
5270,0,014,040,0,360,60,768,306,030,8,50

5280,0,014,040,0,360,60,768,306,030,8,50
5290,0,014,040,0,360,60,768,306,030,8,50
5300,0,014,040,0,360,60,768,306,030,8,50
5310,0,014,040,0,360,60,768,306,030,8,50
5320,0,014,040,0,360,60,768,306,030,8,50
5330,0,014,040,0,360,60,768,306,030,8,50
5340,0,014,040,0,360,60,768,306,030,8,50
5350,0,014,040,0,360,60,768,306,030,8,50

5400,3,,,,,,,0128,,,0
;ザコ020#3#6謎メモ
5460,0,012,016,0,-30,-300,000,512,200,8,200
5520,0,006,036,0,106,-030,000,424,030,8,200
5520,0,006,036,0,306,-030,000,424,030,8,200
5580,0,012,016,0,-30,-080,000,512,200,8,200

; ボス 4 - 射命丸 文 - 
6000,3,,,,,,,0000,,,0
6000,2,4,,,192,-100,000,000,,,200000

; 4面の雑魚は基本的に 500ptsか 2000ptsしか出てこない。
