; 東方模倣風(r39u1) - stage_3
;---------------------------
; 暫定フォーマットは readme_standard.txt 参照。
0010,3,,,,,,,0128,,,0

;;;--- 小手調べ ---

;: メモ  魔-方-陣(幅x高さ==32x32), Ｘ軸(0-10), Ｙ軸(0-7),
;: メモ  (Ｙ軸8の場合画面外に喰み出す 272(psp高さ) < 288 == 256(8の場合)+32(魔-方-陣高さ) )
;   0   1   2   3   4   5   6   7   8   9  10
;   0  32  64  96 128 160 192 224 256 288 320
;   0  40  80 120 160 200 240 280 320  -      (7連用)
;   -  20  60 100 140 180 220 260 300  -      (-20)
0200,3,,,,,,,0025,,,0
;;;--- 魔-方-陣セット;1(下から３段) ---
;魔-方-陣のスペカ
;	1:縦攻撃のスペカ
;	2:ランダムばらまき攻撃("魔方陣2")のスペカ
;	3:ランダムばらまき攻撃+自機狙い("魔方陣1")のスペカ
;	4:円状攻撃のスペカ(小左)
;	5:円状攻撃のスペカ(中右)
;	6:円状攻撃のスペカ(大左)

;右下7連
0240,0,000,046,1,060,96,000,512,030,8,50
0240,0,000,046,1,100,96,000,512,030,8,50
0240,0,000,046,1,140,96,000,512,030,8,50
0240,0,000,046,1,180,96,000,512,030,8,50
0240,0,000,046,1,220,96,000,512,030,8,50
0240,0,000,046,4,260,96,000,512,030,8,50
0240,0,000,046,1,300,96,000,512,030,8,50

;左中7連
0264,0,000,046,1,040,64,000,512,030,8,50
0264,0,000,046,3,080,64,000,512,030,8,50
0264,0,000,046,1,120,64,000,512,030,8,50
0264,0,000,046,1,160,64,000,512,030,8,50
0264,0,000,046,1,200,64,000,512,030,8,50
0264,0,000,046,1,240,64,000,512,030,8,50
0264,0,000,046,1,280,64,000,512,030,8,50

;右上7連
0288,0,000,046,1,060,32,000,512,030,8,50
0288,0,000,046,1,100,32,000,512,030,8,50
0288,0,000,046,1,140,32,000,512,030,8,50
0288,0,000,046,5,180,32,000,512,030,8,50
0288,0,000,046,1,220,32,000,512,030,8,50
0288,0,000,046,1,260,32,000,512,030,8,50
0288,0,000,046,1,300,23,000,512,030,8,50

0800,3,,,,,,,0102,,,0
;;;--- 魔-方-陣セット;2(上から３段) ---

;右上7連
0840,0,000,046,1,060,32,000,512,030,8,50
0840,0,000,046,6,100,32,000,512,030,8,50
0840,0,000,046,1,140,32,000,512,030,8,50
0840,0,000,046,1,180,32,000,512,030,8,50
0840,0,000,046,4,220,32,000,512,030,8,50
0840,0,000,046,1,260,32,000,512,030,8,50
0840,0,000,046,1,300,32,000,512,030,8,50

;左中7連
0864,0,000,046,1,040,64,000,512,030,8,50
0864,0,000,046,1,080,64,000,512,030,8,50
0864,0,000,046,4,120,64,000,512,030,8,50
0864,0,000,046,1,160,64,000,512,030,8,50
0864,0,000,046,1,200,64,000,512,030,8,50
0864,0,000,046,1,240,64,000,512,030,8,50
0864,0,000,046,1,280,64,000,512,030,8,50

;右下7連
0888,0,000,046,1,060,96,000,512,030,8,50
0888,0,000,046,1,100,96,000,512,030,8,50
0888,0,000,046,1,140,96,000,512,030,8,50
0888,0,000,046,1,180,96,000,512,030,8,50
0888,0,000,046,1,220,96,000,512,030,8,50
0888,0,000,046,5,260,96,000,512,030,8,50
0888,0,000,046,1,300,96,000,512,030,8,50

1200,3,,,,,,,0179,,,0
;;;--- 魔-方-陣セット;3(下から２段) ---

;右下7連
1440,0,000,046,1,060,96,000,512,030,8,100
1440,0,000,046,5,100,96,000,512,030,8,100
1440,0,000,046,1,140,96,000,512,030,8,100
1440,0,000,046,1,180,96,000,512,030,8,100
1440,0,000,046,1,220,96,000,512,030,8,100
1440,0,000,046,6,260,96,000,512,030,8,100
1440,0,000,046,1,300,96,000,512,030,8,100

;左中7連
1464,0,000,046,1,040,64,000,512,030,8,100
1464,0,000,046,2,080,64,000,512,030,8,100
1464,0,000,046,1,120,64,000,512,030,8,100
1464,0,000,046,1,160,64,000,512,030,8,100
1464,0,000,046,1,200,64,000,512,030,8,100
1464,0,000,046,1,240,64,000,512,030,8,100
1464,0,000,046,1,280,64,000,512,030,8,100

;右下7連
1488,0,000,046,1,060,96,000,512,030,8,100
1488,0,000,046,4,100,96,000,512,030,8,100
1488,0,000,046,1,140,96,000,512,030,8,100
1488,0,000,046,1,180,96,000,512,030,8,100
1488,0,000,046,1,220,96,000,512,030,8,100
1488,0,000,046,6,260,96,000,512,030,8,100
1488,0,000,046,1,300,96,000,512,030,8,100


1600,3,,,,,,,0256,,,0
;;;--- 魔-方-陣セット;1(下から３段) ---

;右下7連
2040,0,000,046,1,060,96,000,512,030,8,50
2040,0,000,046,5,100,96,000,512,030,8,50
2040,0,000,046,1,140,96,000,512,030,8,50
2040,0,000,046,1,180,96,000,512,030,8,50
2040,0,000,046,1,220,96,000,512,030,8,50
2040,0,000,046,4,260,96,000,512,030,8,50
2040,0,000,046,1,300,96,000,512,030,8,50

;左中7連
2064,0,000,046,1,040,64,000,512,030,8,50
2064,0,000,046,1,080,64,000,512,030,8,50
2064,0,000,046,4,120,64,000,512,030,8,50
2064,0,000,046,1,160,64,000,512,030,8,50
2064,0,000,046,1,200,64,000,512,030,8,50
2064,0,000,046,5,240,64,000,512,030,8,50
2064,0,000,046,1,280,64,000,512,030,8,50

;右上7連
2088,0,000,046,1,060,32,000,512,030,8,50
2088,0,000,046,1,100,32,000,512,030,8,50
2088,0,000,046,6,140,32,000,512,030,8,50
2088,0,000,046,1,180,32,000,512,030,8,50
2088,0,000,046,1,220,32,000,512,030,8,50
2088,0,000,046,5,260,32,000,512,030,8,50
2088,0,000,046,1,300,23,000,512,030,8,50

2600,3,,,,,,,0640,,,0
;;;--- 魔-方-陣セット;2(上から３段) ---

;右上7連
2640,0,000,046,1,060,32,000,512,030,8,50
2640,0,000,046,4,100,32,000,512,030,8,50
2640,0,000,046,1,140,32,000,512,030,8,50
2640,0,000,046,5,180,32,000,512,030,8,50
2640,0,000,046,1,220,32,000,512,030,8,50
2640,0,000,046,6,260,32,000,512,030,8,50
2640,0,000,046,1,300,32,000,512,030,8,50

;左中7連
2664,0,000,046,1,040,64,000,512,030,8,50
2664,0,000,046,1,080,64,000,512,030,8,50
2664,0,000,046,1,120,64,000,512,030,8,50
2664,0,000,046,5,160,64,000,512,030,8,50
2664,0,000,046,1,200,64,000,512,030,8,50
2664,0,000,046,4,240,64,000,512,030,8,50
2664,0,000,046,1,280,64,000,512,030,8,50

;右下7連
2688,0,000,046,1,060,96,000,512,030,8,50
2688,0,000,046,5,100,96,000,512,030,8,50
2688,0,000,046,1,140,96,000,512,030,8,50
2688,0,000,046,1,180,96,000,512,030,8,50
2688,0,000,046,4,220,96,000,512,030,8,50
2688,0,000,046,1,260,96,000,512,030,8,50
2688,0,000,046,1,300,96,000,512,030,8,50

3200,3,,,,,,,1024,,,0
;;;--- 魔-方-陣セット;1(下から３段) ---

;右下7連
3240,0,000,046,1,060,96,000,512,030,8,50
3240,0,000,046,6,100,96,000,512,030,8,50
3240,0,000,046,1,140,96,000,512,030,8,50
3240,0,000,046,4,180,96,000,512,030,8,50
3240,0,000,046,1,220,96,000,512,030,8,50
3240,0,000,046,1,260,96,000,512,030,8,50
3240,0,000,046,1,300,96,000,512,030,8,50

;左中7連
0544,0,000,046,1,040,64,000,512,030,8,50
0544,0,000,046,1,080,64,000,512,030,8,50
0544,0,000,046,1,120,64,000,512,030,8,50
0544,0,000,046,5,160,64,000,512,030,8,50
0544,0,000,046,1,200,64,000,512,030,8,50
0544,0,000,046,1,240,64,000,512,030,8,50
0544,0,000,046,4,280,64,000,512,030,8,50

;右上7連
3288,0,000,046,5,060,32,000,512,030,8,50
3288,0,000,046,1,100,32,000,512,030,8,50
3288,0,000,046,1,140,32,000,512,030,8,50
3288,0,000,046,4,180,32,000,512,030,8,50
3288,0,000,046,1,220,32,000,512,030,8,50
3288,0,000,046,1,260,32,000,512,030,8,50
3288,0,000,046,1,300,23,000,512,030,8,50

3800,3,,,,,,,0128,,,0
;;;--- 魔-方-陣セット;2(上から３段) ---

;右上7連
3840,0,000,046,5,060,32,000,512,030,8,50
3840,0,000,046,1,100,32,000,512,030,8,50
3840,0,000,046,1,140,32,000,512,030,8,50
3840,0,000,046,6,180,32,000,512,030,8,50
3840,0,000,046,1,220,32,000,512,030,8,50
3840,0,000,046,1,260,32,000,512,030,8,50
3840,0,000,046,5,300,32,000,512,030,8,50

;左中7連
3864,0,000,046,1,040,64,000,512,030,8,50
3864,0,000,046,4,080,64,000,512,030,8,50
3864,0,000,046,1,120,64,000,512,030,8,50
3864,0,000,046,4,160,64,000,512,030,8,50
3864,0,000,046,1,200,64,000,512,030,8,50
3864,0,000,046,4,240,64,000,512,030,8,50
3864,0,000,046,1,280,64,000,512,030,8,50

;右下7連
3888,0,000,046,6,060,96,000,512,030,8,50
3888,0,000,046,4,100,96,000,512,030,8,50
3888,0,000,046,1,140,96,000,512,030,8,50
3888,0,000,046,1,180,96,000,512,030,8,50
3888,0,000,046,1,220,96,000,512,030,8,50
3888,0,000,046,5,260,96,000,512,030,8,50
3888,0,000,046,4,300,96,000,512,030,8,50

;;;--- ミックスザコ ---

0600,0,006,036,0,090,-30,000,424,030,8,50
0600,0,006,036,0,290,-30,000,424,030,8,50

1200,0,006,036,0,090,-30,000,424,030,8,50
1200,0,006,036,0,290,-30,000,424,030,8,50
1230,0,006,036,0,090,-30,000,424,030,8,50
1230,0,006,036,0,290,-30,000,424,030,8,50
;
1560,0,018,048,0,030,-20,000,768,072,8,50
1560,0,018,048,0,050,-20,000,768,072,8,50
1575,0,018,048,0,030,-20,000,768,072,8,50
1575,0,018,048,0,050,-20,000,768,072,8,50
1590,0,018,048,0,030,-20,010,768,072,8,50
1590,0,018,048,0,050,-20,010,768,072,8,50
1605,0,018,048,0,030,-20,020,768,072,8,50
1605,0,018,048,0,050,-20,020,768,072,8,50
1620,0,018,048,0,030,-20,030,768,072,8,50
1620,0,018,048,0,050,-20,030,768,072,8,50
1635,0,018,048,0,030,-20,040,768,072,8,50
1635,0,018,048,0,050,-20,040,768,072,8,50
1650,0,018,048,0,030,-20,050,768,072,8,50
1650,0,018,048,0,050,-20,050,768,072,8,50
1665,0,018,048,0,030,-20,060,768,072,8,50
1665,0,018,048,0,050,-20,060,768,072,8,50
1690,0,018,048,0,030,-20,070,768,072,8,50
1690,0,018,048,0,050,-20,070,768,072,8,50
1705,0,018,048,0,030,-20,080,768,072,8,50
1705,0,018,048,0,050,-20,080,768,072,8,50
1720,0,018,048,0,030,-20,090,768,072,8,50
1720,0,018,048,0,050,-20,090,768,072,8,50
1735,0,018,048,0,030,-20,100,768,072,8,50
1735,0,018,048,0,050,-20,100,768,072,8,50
;
1920,0,006,036,0,090,-30,000,424,030,8,30
1920,0,006,036,0,290,-30,000,424,030,8,30
1950,0,006,036,0,090,-30,000,424,030,8,30
1950,0,006,036,0,290,-30,000,424,030,8,30
;
1940,0,018,048,0,300,-20,000,768,072,8,50
1940,0,018,048,0,320,-20,000,768,072,8,50
1955,0,018,048,0,300,-20,000,768,072,8,50
1955,0,018,048,0,320,-20,000,768,072,8,50
1970,0,018,048,0,300,-20,990,768,072,8,50
1970,0,018,048,0,320,-20,990,768,072,8,50
1985,0,018,048,0,300,-20,980,768,072,8,50
1985,0,018,048,0,320,-20,980,768,072,8,50
2000,0,018,048,0,300,-20,970,768,072,8,50
2000,0,018,048,0,320,-20,970,768,072,8,50
2015,0,018,048,0,300,-20,960,768,072,8,50
2015,0,018,048,0,320,-20,960,768,072,8,50
2030,0,018,048,0,300,-20,950,768,072,8,50
2030,0,018,048,0,320,-20,950,768,072,8,50
2045,0,018,048,0,300,-20,940,768,072,8,50
2045,0,018,048,0,320,-20,940,768,072,8,50
2070,0,018,048,0,300,-20,930,768,072,8,50
2070,0,018,048,0,320,-20,930,768,072,8,50
2085,0,018,048,0,300,-20,920,768,072,8,50
2085,0,018,048,0,320,-20,920,768,072,8,50
2100,0,018,048,0,300,-20,910,768,072,8,50
2100,0,018,048,0,320,-20,910,768,072,8,50
2115,0,018,048,0,300,-20,900,768,072,8,50
2115,0,018,048,0,320,-20,900,768,072,8,50
;
1980,0,006,036,0,090,-30,000,424,030,8,30
1980,0,006,036,0,290,-30,000,424,030,8,30
2010,0,006,036,0,090,-30,000,424,030,8,30
2010,0,006,036,0,290,-30,000,424,030,8,30
; #002-陰-陽-玉
2000,0,002,029,0,032,-512,000,512,030,10,50
2000,0,002,029,0,288,-512,000,512,030,10,50
2000,0,002,029,0,147,-512,000,512,030,10,50
2000,0,002,029,0,078,-512,000,512,030,10,50
2000,0,002,029,0,211,-512,000,512,030,10,50
; 
2100,0,002,029,1,128,-512,000,512,030,10,50
2100,0,002,029,1,194,-512,000,512,030,10,50
2100,0,002,029,1,064,-512,000,512,030,10,50
2100,0,002,029,1,160,-512,000,512,030,10,50
2100,0,002,029,1,141,-512,000,512,030,10,50
; 
2200,0,002,029,2,089,-512,000,512,030,10,50
2200,0,002,029,2,184,-512,000,512,030,10,50
2200,0,002,029,2,075,-512,000,512,030,10,50
2200,0,002,029,2,050,-512,000,512,030,10,50
2200,0,002,029,2,159,-512,000,512,030,10,50
; 
2300,0,002,029,3,211,-512,000,512,030,10,50
2300,0,002,029,3,138,-512,000,512,030,10,50
2300,0,002,029,3,094,-512,000,512,030,10,50
2300,0,002,029,3,137,-512,000,512,030,10,50
2300,0,002,029,3,144,-512,000,512,030,10,50
;
2460,0,008,060,0,125,-50,000,640,700,8,100
2460,0,008,060,0,310,-50,000,640,700,8,100
2460,0,008,060,0,144,-50,000,640,700,8,100
;
2700,0,005,044,0,050,-30,000,384,972,8,50
;
3120,0,008,060,0,122,-50,000,640,800,8,100
3120,0,008,060,0,098,-50,000,640,800,8,100
3120,0,008,060,0,312,-50,000,640,800,8,100
;

3360,0,005,044,0,128,-30,000,384,800,8,50
;
3420,0,008,060,0,258,-50,000,640,900,8,100
3420,0,008,060,0,021,-50,000,640,900,8,100
3420,0,008,060,0,149,-50,000,640,900,8,100
;
3480,0,005,044,0,270,-30,000,384,720,8,50


; 小悪魔
3650,1,0,000,7,150,50,000,512,1856,15,10000

;最後-メ-イ-ド
;
3660,0,017,048,0,010,010,796,384,800,8,100
3670,0,017,048,0,350,010,227,384,800,8,100
3680,0,017,048,0,010,010,796,384,800,8,100
3690,0,017,048,0,350,010,227,384,800,8,100
;
3700,0,017,048,0,010,010,796,384,800,8,100
3710,0,017,048,0,350,010,227,384,800,8,100
3720,0,017,048,0,010,010,796,384,800,8,100
3730,0,017,048,0,350,010,227,384,800,8,100
;
3740,0,017,048,0,010,010,796,384,900,8,100
3750,0,017,048,0,350,010,227,384,900,8,100
3760,0,017,048,0,010,010,796,384,900,8,100
3770,0,017,048,0,350,010,227,384,900,8,100
;
3780,0,017,048,0,010,010,796,384,900,8,100
3790,0,017,048,0,350,010,227,384,900,8,100
3800,0,017,048,0,010,010,796,384,900,8,100
3810,0,017,048,0,350,010,227,384,900,8,100
;
3820,0,017,048,0,010,010,796,384,900,8,100
3830,0,017,048,0,350,010,227,384,900,8,100
3840,0,017,048,0,010,010,796,384,900,8,100
3850,0,017,048,0,350,010,227,384,900,8,100

; ボス 3 - 蓬莱山 輝夜 - 
4620,3,,,,,,,0000,,,0
4620,2,3,,,192,-100,000,001,,,200000

; 3面の雑魚は基本的に 300ptsか 500ptsか 1000ptsしか出てこない。
