; 東方模倣風(r39u1) - stage_5
;---------------------------
; 暫定フォーマットは readme_standard.txt 参照。
0010,3,,,,,,,0128,,,0

; 0240,0,02 1,016,0,240,10,030,8,200
; 6番目: 速度(負数は逆方向へ移動) [正数右移動→] [負数左移動←] [速度==256 は 1/60秒で1 ドット移動する速さ]
; 7番目: 出現Y座標

;[青-妖精群、前半](ミックスなので単体ではぬるく)

0240,0,014,016,0,-30,010,256,240,030,8,200
0300,0,014,024,0,360,160,768,290,030,8,200
0360,0,014,016,0,-30,040,256,250,030,8,200
0420,0,014,024,0,360,130,768,280,030,8,200
 
0480,0,014,016,0,-30,070,256,260,030,8,200
0540,0,014,024,0,360,100,768,270,030,8,200
0600,0,014,016,0,-30,100,256,270,030,8,200
0660,0,014,024,0,360,070,768,260,030,8,200
 
0720,0,014,016,0,-30,130,256,280,030,8,200
0780,0,014,024,0,360,040,768,250,030,8,200
0840,0,014,016,0,-30,160,256,290,030,8,200
0900,0,014,024,0,360,010,768,240,030,8,200

;[青-妖精群、後半](後半の方が若干速度が速い)

0960,0,014,016,0,-30,010,256,300,030,8,200
1020,0,014,024,0,360,160,768,350,030,8,200
1080,0,014,016,0,-30,040,256,310,030,8,200
1140,0,014,024,0,360,130,768,340,030,8,200
 
1200,0,014,016,0,-30,070,256,320,030,8,200
1260,0,014,024,0,360,100,768,330,030,8,200
1320,0,014,016,0,-30,100,256,330,030,8,200
1380,0,014,024,0,360,070,768,320,030,8,200
 
1440,0,014,016,0,-30,130,256,340,030,8,200
1500,0,014,024,0,360,040,768,310,030,8,200
1560,0,014,016,0,-30,160,256,350,030,8,200
1620,0,014,024,0,360,010,768,300,030,8,200

; 0600,1,1,016,7,0016,050,000,512,1856,14,70
;/r32/ 3番目: 弾幕種類+ボス種類(番号は仮です。) 
;/r33/ 3番目: ボス種類(番号は仮です。) 
;/r33/ 5番目: 弾幕種類(番号は仮です。) 
; 6番目: 出現X座標
; 7番目: 出現Y座標

;[ミックス](青-妖精群だけでは単調なので、中ボスを混ぜる)
; 毛玉ラッシュが左側から始まるので接続を考えて配置

; 弾幕種類(番号は仮です。開発が進むと残念ながら番号が変わりますのでDATにメモっておきます) 
; 弾幕種類(メモ)
; 5,	拡散型全方位ナイフ弾	danmaku_create_05_32way_dual
; 7,	拡散型全方位ナイフ弾	danmaku_create_07_80way_dual_five


;---------- ",1,0," == 犬走 椛, 30==ののじ弾幕(仮)
;2640,1,0,000,30,200,50,000,512,1856,15,10000; (HP:1856, ITEM:15==(旧ルーミア互換仕様) 数値:1万(==10万pts). [r34])
; ( 弾幕種類:30==ののじっぽい弾幕(仮), HP:18560, ITEM:3==(1up) 数値:1万(==10万pts). [r35])
;2640,1,0,000,30,200,50,000,512,18560,3,10000
;2640,1,0,000,30,200,50,000,512,8888,3,10000

; 小悪魔, 31==小悪魔っぽい弾幕(仮) HP:6666, ITEM:1==(大p), ITEM:4==(ボム)
2800,1,0,000,31,250,50,000,512,6666,4,10000
;3000,1,0,000,7,150,50,000,512,1856,4,10000

;

; 4面 毛玉ラッシュもどき(あんま似てない)

; 1800,0,011,047,0,速度(負数の場合は逆方向へ移動),Y座標(負数の場合はX座標),000,512,030,8,200
; 2番目: 0:紅っぽい毛玉(狭角度 奇数弾) 1:妖っぽい毛玉(90度 4方向) (無駄弾なので難易度は低い筈)
; 4番目: 速度(負数は逆方向へ移動) [正数右移動→] [負数左移動←] [速度==256 は 1/60秒で1 ドット移動する速さ]
; 5番目: 出現Y座標(負数の場合は出現X座標)

; 下移動([1]左 [2]中)
1800,0,011,047,0,320,-088,000,512,080,8,70
1816,0,011,047,0,320,-088,000,512,080,8,70
1832,0,011,047,0,320,-088,000,512,080,8,70
1848,0,011,047,0,320,-088,000,512,080,8,70
1864,0,011,047,0,320,-088,000,512,080,8,70
1880,0,011,047,0,320,-088,000,512,080,8,70
1950,0,011,047,0,320,-176,000,512,080,8,70
1966,0,011,047,0,320,-176,000,512,080,8,70
1982,0,011,047,0,320,-176,000,512,080,8,70
1998,0,011,047,0,320,-176,000,512,080,8,70
2014,0,011,047,0,320,-176,000,512,080,8,70
2030,0,011,047,0,320,-176,000,512,080,8,70

; 横移動([3]左中 [4]右下)
2100,0,011,047,0,0414,64,000,512,080,8,70
2116,0,011,047,0,0414,64,000,512,080,8,70
2132,0,011,047,0,0414,64,000,512,080,8,70
2148,0,011,047,0,0414,64,000,512,080,8,70
2164,0,011,047,0,0414,64,000,512,080,8,70
2180,0,011,047,0,0414,64,000,512,080,8,70
2250,0,011,047,0,-414,96,000,512,080,8,70
2266,0,011,047,0,-414,96,000,512,080,8,70
2282,0,011,047,0,-414,96,000,512,080,8,70
2298,0,011,047,0,-414,96,000,512,080,8,70
2314,0,011,047,0,-414,96,000,512,080,8,70
2330,0,011,047,0,-414,96,000,512,080,8,70

; 下移動([5]右 [6]中)
2400,0,011,047,0,320,-264,000,512,080,8,70
2416,0,011,047,0,320,-264,000,512,080,8,70
2432,0,011,047,0,320,-264,000,512,080,8,70
2448,0,011,047,0,320,-264,000,512,080,8,70
2464,0,011,047,0,320,-264,000,512,080,8,70
2480,0,011,047,0,320,-264,000,512,080,8,70
2550,0,011,047,0,320,-176,000,512,080,8,70
2566,0,011,047,0,320,-176,000,512,080,8,70
2582,0,011,047,0,320,-176,000,512,080,8,70
2598,0,011,047,0,320,-176,000,512,080,8,70
2614,0,011,047,0,320,-176,000,512,080,8,70
2630,0,011,047,0,320,-176,000,512,080,8,70

; 横移動([7]右上 [8]左中)
2700,0,011,047,0,-414,32,000,512,080,8,70
2716,0,011,047,0,-414,32,000,512,080,8,70
2732,0,011,047,0,-414,32,000,512,080,8,70
2748,0,011,047,0,-414,32,000,512,080,8,70
2764,0,011,047,0,-414,32,000,512,080,8,70
2780,0,011,047,0,-414,32,000,512,080,8,70

;;---小悪魔で出ない(r35)
;2850,0,011,047,0,0414,64,000,512,080,8,70
;2866,0,011,047,0,0414,64,000,512,080,8,70
;2882,0,011,047,0,0414,64,000,512,080,8,70
;2898,0,011,047,0,0414,64,000,512,080,8,70
;2914,0,011,047,0,0414,64,000,512,080,8,70
;2930,0,011,047,0,0414,64,000,512,080,8,70

; メモ：X座標 [左88]  [中心176] [右264] [最大352]
; メモ：Y座標 [上32]  [中心 64] [下 96] [最大128]
; メモ：414 == 320*[1.29 game aspect rate]

; 1.29411764705882352941176470588235 == [1.29 game aspect rate] == (480[psp横] - 128[サイドパネル]) / 272[psp縦]
; 414.117647058823529411764705882353


; 毛玉ラッシュ2a

; 下移動([1]左 [2]中)
3100,0,011,047,0,320,-088,000,512,080,8,70
3116,0,011,047,0,320,-088,000,512,080,8,70
3132,0,011,047,0,320,-088,000,512,080,8,70
3148,0,011,047,0,320,-088,000,512,080,8,70
3164,0,011,047,0,320,-088,000,512,080,8,70
3180,0,011,047,0,320,-088,000,512,080,8,70
3250,0,011,047,0,320,-176,000,512,080,8,70
3266,0,011,047,0,320,-176,000,512,080,8,70
3282,0,011,047,0,320,-176,000,512,080,8,70
3298,0,011,047,0,320,-176,000,512,080,8,70
3314,0,011,047,0,320,-176,000,512,080,8,70
3330,0,011,047,0,320,-176,000,512,080,8,70

; 横移動([3]左中 [4]右下)
3400,0,011,047,0,0414,64,000,512,080,8,70
3416,0,011,047,0,0414,64,000,512,080,8,70
3432,0,011,047,0,0414,64,000,512,080,8,70
3448,0,011,047,0,0414,64,000,512,080,8,70
3464,0,011,047,0,0414,64,000,512,080,8,70
3480,0,011,047,0,0414,64,000,512,080,8,70
3550,0,011,047,0,-414,96,000,512,080,8,70
3566,0,011,047,0,-414,96,000,512,080,8,70
3582,0,011,047,0,-414,96,000,512,080,8,70
3598,0,011,047,0,-414,96,000,512,080,8,70
3614,0,011,047,0,-414,96,000,512,080,8,70
3630,0,011,047,0,-414,96,000,512,080,8,70

; 下移動([5]右 [6]中)
3700,0,011,047,0,320,-264,000,512,080,8,70
3716,0,011,047,0,320,-264,000,512,080,8,70
3732,0,011,047,0,320,-264,000,512,080,8,70
3748,0,011,047,0,320,-264,000,512,080,8,70
3764,0,011,047,0,320,-264,000,512,080,8,70
3780,0,011,047,0,320,-264,000,512,080,8,70
3850,0,011,047,0,320,-176,000,512,080,8,70
3866,0,011,047,0,320,-176,000,512,080,8,70
3882,0,011,047,0,320,-176,000,512,080,8,70
3898,0,011,047,0,320,-176,000,512,080,8,70
3914,0,011,047,0,320,-176,000,512,080,8,70
3930,0,011,047,0,320,-176,000,512,080,8,70

; 横移動([7]右上 [8]左中)
4000,0,011,047,0,-414,32,000,512,080,8,70
4016,0,011,047,0,-414,32,000,512,080,8,70
4032,0,011,047,0,-414,32,000,512,080,8,70
4048,0,011,047,0,-414,32,000,512,080,8,70
4064,0,011,047,0,-414,32,000,512,080,8,70
4080,0,011,047,0,-414,32,000,512,080,8,70
4150,0,011,047,0,0414,64,000,512,080,8,70
4166,0,011,047,0,0414,64,000,512,080,8,70
4182,0,011,047,0,0414,64,000,512,080,8,70
4198,0,011,047,0,0414,64,000,512,080,8,70
4214,0,011,047,0,0414,64,000,512,080,8,70
4230,0,011,047,0,0414,64,000,512,080,8,70

; 毛玉ラッシュ2b

; 下移動([1]左 [2]中)
3100,0,011,047,1,320,-088,000,512,080,8,70
3116,0,011,047,1,320,-088,000,512,080,8,70
3132,0,011,047,1,320,-088,000,512,080,8,70
3148,0,011,047,1,320,-088,000,512,080,8,70
3164,0,011,047,1,320,-088,000,512,080,8,70
3180,0,011,047,1,320,-088,000,512,080,8,70
3250,0,011,047,1,320,-176,000,512,080,8,70
3266,0,011,047,1,320,-176,000,512,080,8,70
3282,0,011,047,1,320,-176,000,512,080,8,70
3298,0,011,047,1,320,-176,000,512,080,8,70
3314,0,011,047,1,320,-176,000,512,080,8,70
3330,0,011,047,1,320,-176,000,512,080,8,70

; 横移動([3]左中 [4]右下)
3400,0,011,047,1,0414,64,000,512,080,8,70
3416,0,011,047,1,0414,64,000,512,080,8,70
3432,0,011,047,1,0414,64,000,512,080,8,70
3448,0,011,047,1,0414,64,000,512,080,8,70
3464,0,011,047,1,0414,64,000,512,080,8,70
3480,0,011,047,1,0414,64,000,512,080,8,70
3550,0,011,047,1,-414,96,000,512,080,8,70
3566,0,011,047,1,-414,96,000,512,080,8,70
3582,0,011,047,1,-414,96,000,512,080,8,70
3598,0,011,047,1,-414,96,000,512,080,8,70
3614,0,011,047,1,-414,96,000,512,080,8,70
3630,0,011,047,1,-414,96,000,512,080,8,70

; 下移動([5]右 [6]中)
3700,0,011,047,1,320,-264,000,512,080,8,70
3716,0,011,047,1,320,-264,000,512,080,8,70
3732,0,011,047,1,320,-264,000,512,080,8,70
3748,0,011,047,1,320,-264,000,512,080,8,70
3764,0,011,047,1,320,-264,000,512,080,8,70
3780,0,011,047,1,320,-264,000,512,080,8,70
3850,0,011,047,1,320,-176,000,512,080,8,70
3866,0,011,047,1,320,-176,000,512,080,8,70
3882,0,011,047,1,320,-176,000,512,080,8,70
3898,0,011,047,1,320,-176,000,512,080,8,70
3914,0,011,047,1,320,-176,000,512,080,8,70
3930,0,011,047,1,320,-176,000,512,080,8,70

; 横移動([7]右上 [8]左中)
4000,0,011,047,1,-414,32,000,512,080,8,70
4016,0,011,047,1,-414,32,000,512,080,8,70
4032,0,011,047,1,-414,32,000,512,080,8,70
4048,0,011,047,1,-414,32,000,512,080,8,70
4064,0,011,047,1,-414,32,000,512,080,8,70
4080,0,011,047,1,-414,32,000,512,080,8,70
4150,0,011,047,1,0414,64,000,512,080,8,70
4166,0,011,047,1,0414,64,000,512,080,8,70
4182,0,011,047,1,0414,64,000,512,080,8,70
4198,0,011,047,1,0414,64,000,512,080,8,70
4214,0,011,047,1,0414,64,000,512,080,8,70
4230,0,011,047,1,0414,64,000,512,080,8,70


;[青-妖精群、前半](ミックスなので単体ではぬるく)

3240,0,014,016,0,-30,010,256,240,030,8,200
3300,0,014,024,0,360,160,768,290,030,8,200
3360,0,014,016,0,-30,040,256,250,030,8,200
3420,0,014,024,0,360,130,768,280,030,8,200
                          
3480,0,014,016,0,-30,070,256,260,030,8,200
3540,0,014,024,0,360,100,768,270,030,8,200
3600,0,014,016,0,-30,100,256,270,030,8,200
3660,0,014,024,0,360,070,768,260,030,8,200
                          
3720,0,014,016,0,-30,130,256,280,030,8,200
3780,0,014,024,0,360,040,768,250,030,8,200
3840,0,014,016,0,-30,160,256,290,030,8,200
3900,0,014,024,0,360,010,768,240,030,8,200

;[青-妖精群、後半](後半の方が若干速度が速い)

3960,0,014,016,0,-30,010,256,300,030,8,200
4020,0,014,024,0,360,160,768,350,030,8,200
4080,0,014,016,0,-30,040,256,310,030,8,200
4140,0,014,024,0,360,130,768,340,030,8,200
                          
4200,0,014,016,0,-30,070,256,320,030,8,200
4260,0,014,024,0,360,100,768,330,030,8,200
4320,0,014,016,0,-30,100,256,330,030,8,200
4380,0,014,024,0,360,070,768,320,030,8,200
                          
4440,0,014,016,0,-30,130,256,340,030,8,200
4500,0,014,024,0,360,040,768,310,030,8,200
4560,0,014,016,0,-30,160,256,350,030,8,200
4620,0,014,024,0,360,010,768,300,030,8,200

;テキトー魔-方-陣

4600,0,000,046,2,096,032,000,512,030,8,200
4610,0,000,046,2,192,032,000,512,030,8,200
4620,0,000,046,4,064,064,000,512,030,8,200
4630,0,000,046,2,192,064,000,512,030,8,200
4640,0,000,046,2,224,096,000,512,030,8,200
4650,0,000,046,2,270,096,000,512,030,8,200
4660,0,000,046,2,288,064,000,512,030,8,200
4670,0,000,046,6,224,064,000,512,030,8,200
4680,0,000,046,2,128,096,000,512,030,8,200
4690,0,000,046,2,160,096,000,512,030,8,200
4700,0,000,046,2,096,032,000,512,030,8,200

; ボス 5 - パチュリー・ノーレッジ - 
5000,3,,,,,,,0000,,,0
5000,2,5,,,192,-100,000,000,,,60000
