; 東方模倣風(r39u1) - stage_8 (extra stage)
;---------------------------
; 暫定フォーマットは readme_standard.txt 参照。
0010,3,,,,,,,0128,,,0

; ザリザリ。パワーアップしていってね。

;; [ザリザリ横]、左上→右上へ 
; 下移動([1]左 [2]中)
0300,0,011,047,0,512,080,000,512,001,1,70
0308,0,011,047,0,512,080,000,512,001,1,70
0316,0,011,047,0,512,080,000,512,001,1,70
0324,0,011,047,0,512,080,000,512,001,1,70
0332,0,011,047,0,512,080,000,512,001,1,70
0340,0,011,047,0,512,080,000,512,001,1,70
0348,0,011,047,0,512,080,000,512,001,1,70
0356,0,011,047,0,512,080,000,512,001,1,70
0364,0,011,047,0,512,080,000,512,001,1,70
0372,0,011,047,0,512,080,000,512,001,1,70
0380,0,011,047,0,512,080,000,512,001,1,70
0388,0,011,047,0,512,080,000,512,001,1,70

;; [ザリザリ横]、右上→左上へ 
; 下移動([5]右 [6]中)  ;(隠しボム有り)
0500,0,011,047,0,-512,080,000,512,001,1,70
0508,0,011,047,0,-512,080,000,512,001,1,70
0516,0,011,047,0,-512,080,000,512,001,1,70
0524,0,011,047,0,-512,080,000,512,001,4,70
0532,0,011,047,0,-512,080,000,512,001,1,70
0540,0,011,047,0,-512,080,000,512,001,1,70
0548,0,011,047,0,-512,080,000,512,001,1,70
0556,0,011,047,0,-512,080,000,512,001,1,70
0564,0,011,047,0,-512,080,000,512,001,1,70
0572,0,011,047,0,-512,080,000,512,001,1,70
0580,0,011,047,0,-512,080,000,512,001,1,70
0588,0,011,047,0,-512,080,000,512,001,1,70

;---- この辺でステージ開始からの無敵時間が切れる。 ----

;; ザリザリ左右同時 

;; [ザリザリ縦]、左上→左下へ 
; 下移動([1]左 [2]中)
1000,0,011,047,0,512,-048,000,512,001,0,70
1008,0,011,047,0,400,-048,000,512,001,0,70
1016,0,011,047,0,480,-048,000,512,001,0,70
1024,0,011,047,0,320,-048,000,512,001,0,70
1032,0,011,047,0,512,-048,000,512,001,0,70
1040,0,011,047,0,400,-048,000,512,001,0,70
1048,0,011,047,0,480,-048,000,512,001,0,70
1056,0,011,047,0,320,-048,000,512,001,0,70
1064,0,011,047,0,512,-048,000,512,001,0,70
1072,0,011,047,0,400,-048,000,512,001,0,70
1080,0,011,047,0,480,-048,000,512,001,0,70
1088,0,011,061,0,300,-048,000,512,001,4,300

;; [ザリザリ縦]、右上→右下へ 
; 下移動([5]右 [6]中)
1000,0,011,047,0,512,-328,000,512,001,0,70
1008,0,011,047,0,400,-328,000,512,001,0,70
1016,0,011,047,0,480,-328,000,512,001,0,70
1024,0,011,047,0,320,-328,000,512,001,0,70
1032,0,011,047,0,512,-328,000,512,001,0,70
1040,0,011,047,0,400,-328,000,512,001,0,70
1048,0,011,047,0,480,-328,000,512,001,0,70
1056,0,011,047,0,320,-328,000,512,001,0,70
1064,0,011,047,0,512,-328,000,512,001,0,70
1072,0,011,047,0,400,-328,000,512,001,0,70
1080,0,011,047,0,480,-328,000,512,001,0,70
1088,0,011,061,0,300,-328,000,512,001,4,300


; 0240,0,02 1,016,0,240,10,000,512,030,8,30
; 6番目: 速度(負数は逆方向へ移動) [正数右移動→] [負数左移動←] [速度==256 は 1/60秒で1 ドット移動する速さ]
; 7番目: 出現Y座標

;[青-妖精群、前半](ミックスなので単体ではぬるく)
;+60
0600,0,014,016,0,-30,010,256,240,010,5,100
0660,0,014,016,0,360,160,768,290,020,5,100
0720,0,014,016,0,-30,040,256,250,030,5,100
0780,0,014,016,0,360,130,768,280,040,5,100
;+60                     
0840,0,014,016,0,-30,070,256,260,030,5,100
0900,0,014,016,0,360,100,768,270,030,5,100
0960,0,014,016,0,-30,100,256,270,030,5,100
1020,0,014,016,0,360,070,768,260,030,5,100
;+60                     
1080,0,014,016,0,-30,130,256,280,030,5,100
1140,0,014,016,0,360,040,768,250,030,5,100
1200,0,014,052,0,-30,160,256,290,030,4,300
1260,0,014,052,0,360,010,768,240,030,4,300

;[青-妖精群、中半](後半の方が若干速度が速い)
;+50
1310,0,014,016,0,-30,010,256,300,030,5,100
1360,0,014,016,0,360,160,768,350,030,5,100
1410,0,014,016,0,-30,040,256,310,030,5,100
1460,0,014,016,0,360,130,768,340,030,5,100
;+50                     
1510,0,014,016,0,-30,070,256,320,010,5,100
1560,0,014,016,0,360,100,768,330,020,5,100
1610,0,014,016,0,-30,100,256,330,030,5,100
1660,0,014,016,0,360,070,768,320,040,5,100
;+50                     
1710,0,014,016,0,-30,130,256,340,030,5,100
1760,0,014,016,0,360,040,768,310,030,5,100
1810,0,014,052,0,-30,160,256,350,030,4,300
1860,0,014,016,0,360,010,768,300,030,5,100

;[青-妖精群、後半](後半の方が速度が速い)
;+40
1900,0,014,016,0,-30,010,256,240,030,5,100
1940,0,014,016,0,360,160,768,290,030,5,100
1980,0,014,016,0,-30,040,256,250,030,5,100
2020,0,014,016,0,360,130,768,280,030,5,100
;+40                     
2060,0,014,016,0,-30,070,256,260,030,5,100
2100,0,014,016,0,360,100,768,270,030,5,100
2140,0,014,016,0,-30,100,256,270,030,5,100
2180,0,014,016,0,360,070,768,260,030,5,100
;+40                     
2220,0,014,016,0,-30,130,256,280,010,5,100
2260,0,014,016,0,360,040,768,250,020,5,100
2300,0,014,052,0,-30,160,256,290,030,4,300
2340,0,014,016,0,360,010,768,240,040,5,100


; 0600,1,1,016,7,16,50,000,512,1856,14,10000
; 3番目: /r32/弾幕種類+a(番号は仮です。) 
; 6番目: 出現X座標
; 7番目: 出現Y座標

;[ミックス](青-妖精群だけでは単調なので、中ボスを混ぜる)
; 毛玉ラッシュが左側から始まるので接続を考えて配置

; 弾幕種類(番号は仮です。開発が進むと残念ながら番号が変わりますのでDATにメモっておきます) 
; 弾幕種類(メモ)
; 5,	拡散型全方位ナイフ弾	danmaku_create_05_32way_dual
; 7,	拡散型全方位ナイフ弾	danmaku_create_07_80way_dual_five

;	/* /r32/(37==32+5) 8:紅1面ボス ルーミア 夜符「ナイトバード」にちょっとだけ似た弾幕(予定) */
;	/* /r32/(38==32+6) 8:紅1面ボス ルーミア 夜符「ナイトバード」にちょっとだけ似た弾幕(予定) */
;	/* /r32/(39==32+7) 8:紅1面ボス ルーミア 夜符「ナイトバード」にちょっとだけ似た弾幕(予定) */


; x未定x小悪魔; 1upサービス
2400,1,0,000,7,150,50,000,512,1856,3,10000
;2400,1,0,000,7,150,50,000,512,1856,15,10000
;2700,1,0,000,7,150,50,000,512,1856,4,10000


;[青-妖精群、後半](後半の方が速度が速い)
;+40
2700,0,014,016,0,-30,010,256,240,030,5,100
2740,0,014,016,0,360,160,768,290,030,5,100
2780,0,014,016,0,-30,040,256,250,030,5,100
2820,0,014,016,0,360,130,768,280,030,5,100
;+40                     
2860,0,014,016,0,-30,070,256,260,030,5,100
2900,0,014,016,0,360,100,768,270,030,5,100
2940,0,014,016,0,-30,100,256,270,030,5,100
2980,0,014,016,0,360,070,768,260,030,5,100
;+40                     
3020,0,014,016,0,-30,130,256,280,030,5,100
3060,0,014,016,0,360,040,768,250,030,5,100
3100,0,014,016,0,-30,160,256,290,030,5,100
3140,0,014,052,0,360,010,768,240,030,4,300

;

; 4面 毛玉ラッシュもどき(あんま似てない)

; 2000,0,011,047,0,速度(負数の場合は逆方向へ移動),Y座標(負数の場合はX座標),000,512,030,8,30
; /r??/2番目: 0:紅っぽい毛玉(狭角度 奇数弾) 1:妖っぽい毛玉(90度 4方向) (無駄弾なので難易度は低い筈)
; /r??/4番目: 速度(負数は逆方向へ移動) [正数右移動→] [負数左移動←] [速度==256 は 1/60秒で1 ドット移動する速さ]
; /r??/5番目: 出現Y座標(負数の場合は出現X座標)

;; [後半ザリザリ]

;; [ザリザリ縦]、後半-A

; [毛玉縦]、下移動([1]左 [2]中)
1300,0,011,047,0,512,-088,000,512,040,5,70
1308,0,011,047,0,400,-088,000,512,040,5,70
1316,0,011,047,0,480,-088,000,512,040,5,70
1324,0,011,047,0,320,-088,000,512,040,5,70
1332,0,011,047,0,512,-088,000,512,040,5,70
1340,0,011,047,0,400,-088,000,512,040,5,70
1348,0,011,047,0,480,-088,000,512,040,5,70
1356,0,011,047,0,320,-088,000,512,040,5,70
1364,0,011,047,0,512,-088,000,512,040,5,70
1372,0,011,047,0,400,-088,000,512,040,5,70
1380,0,011,047,0,480,-088,000,512,040,5,70
1388,0,011,047,0,320,-088,000,512,040,5,70
;
1600,0,011,047,0,512,-176,000,512,040,5,70
1608,0,011,047,0,400,-176,000,512,040,5,70
1616,0,011,047,0,480,-176,000,512,040,5,70
1624,0,011,047,0,320,-176,000,512,040,5,70
1632,0,011,047,0,512,-176,000,512,040,5,70
1640,0,011,047,0,400,-176,000,512,040,5,70
1648,0,011,047,0,480,-176,000,512,040,5,70
1656,0,011,047,0,320,-176,000,512,040,5,70
1664,0,011,047,0,512,-176,000,512,040,5,70
1672,0,011,047,0,400,-176,000,512,040,5,70
1680,0,011,047,0,480,-176,000,512,040,5,70
1688,0,011,061,0,300,-176,000,512,040,4,70

;; [ザリザリ横]、後半-B

; [毛玉横]、横移動([3]左中 [4]右下)
1800,0,011,047,0,0512,64,000,512,040,5,70
1808,0,011,047,0,0512,64,000,512,040,5,70
1816,0,011,047,0,0512,64,000,512,040,5,70
1824,0,011,047,0,0512,64,000,512,040,5,70
1832,0,011,047,0,0512,64,000,512,040,5,70
1840,0,011,047,0,0512,64,000,512,040,5,70
1848,0,011,047,0,0512,64,000,512,040,5,70
1856,0,011,047,0,0512,64,000,512,040,5,70
1864,0,011,047,0,0512,64,000,512,040,5,70
1872,0,011,047,0,0512,64,000,512,040,5,70
1880,0,011,047,0,0512,64,000,512,040,5,70
1888,0,011,047,0,0414,64,000,512,040,1,70
;
2000,0,011,047,0,-512,96,000,512,040,5,70
2008,0,011,047,0,-512,96,000,512,040,5,70
2016,0,011,047,0,-512,96,000,512,040,5,70
2024,0,011,047,0,-512,96,000,512,040,5,70
2032,0,011,047,0,-512,96,000,512,040,5,70
2040,0,011,047,0,-512,96,000,512,040,5,70
2048,0,011,047,0,-512,96,000,512,040,5,70
2056,0,011,047,0,-512,96,000,512,040,5,70
2064,0,011,047,0,-512,96,000,512,040,5,70
2072,0,011,047,0,-512,96,000,512,040,5,70
2080,0,011,047,0,-512,96,000,512,040,5,70
2088,0,011,047,0,-414,96,000,512,040,1,70

;; [ザリザリ縦]、後半-C

; [毛玉縦]、下移動([5]右 [6]中)
2200,0,011,047,0,320,-264,000,512,030,5,70
2208,0,011,047,0,320,-264,000,512,030,5,70
2216,0,011,047,0,320,-264,000,512,030,5,70
2224,0,011,047,0,320,-264,000,512,030,5,70
2232,0,011,047,0,320,-264,000,512,030,1,70
2240,0,011,047,0,320,-264,000,512,030,1,70
2248,0,011,047,0,320,-264,000,512,030,1,70
2256,0,011,047,0,320,-264,000,512,030,5,70
2264,0,011,047,0,320,-264,000,512,030,5,70
2272,0,011,047,0,320,-264,000,512,030,5,70
2280,0,011,047,0,320,-264,000,512,030,5,70
2288,0,011,047,0,320,-264,000,512,030,5,70
;--少し休み--
2600,0,011,047,0,320,-176,000,512,030,5,70
2608,0,011,047,0,320,-176,000,512,030,5,70
2616,0,011,047,0,320,-176,000,512,030,5,70
2624,0,011,047,0,320,-176,000,512,030,5,70
2632,0,011,047,0,320,-176,000,512,030,1,70
2640,0,011,047,0,320,-176,000,512,030,1,70
2648,0,011,047,0,320,-176,000,512,030,1,70
2656,0,011,047,0,320,-176,000,512,030,5,70
2664,0,011,047,0,320,-176,000,512,030,5,70
2672,0,011,047,0,320,-176,000,512,030,5,70
2680,0,011,047,0,320,-176,000,512,030,5,70
2688,0,011,061,0,320,-176,000,512,030,4,70
;--少し休み--
;--少し休み--

;; [ザリザリ横]、後半-D

; [毛玉横]、横移動([7]右上 [8]左中)
2800,0,011,047,0,-512,32,000,512,020,5,70
2808,0,011,047,0,-512,32,000,512,020,5,70
2816,0,011,047,0,-512,32,000,512,020,5,70
2824,0,011,047,0,-512,32,000,512,020,5,70
2832,0,011,047,0,-512,32,000,512,020,5,70
2840,0,011,047,0,-512,32,000,512,020,5,70
2848,0,011,047,0,-512,32,000,512,020,5,70
2856,0,011,047,0,-512,32,000,512,020,5,70
2864,0,011,047,0,-512,32,000,512,020,5,70
2872,0,011,047,0,-512,32,000,512,020,5,70
2880,0,011,047,0,-512,32,000,512,020,5,70
2888,0,011,047,0,-414,32,000,512,020,5,70
;
3000,0,011,047,0,0512,64,000,512,010,5,70
3008,0,011,047,0,0512,64,000,512,010,5,70
3016,0,011,047,0,0512,64,000,512,010,5,70
3024,0,011,047,0,0512,64,000,512,010,5,70
3032,0,011,047,0,0512,64,000,512,010,5,70
3040,0,011,047,0,0512,64,000,512,010,5,70
3048,0,011,047,0,0512,64,000,512,010,5,70
3056,0,011,047,0,0512,64,000,512,010,5,70
3064,0,011,047,0,0512,64,000,512,010,5,70
3072,0,011,047,0,0512,64,000,512,010,5,70
3080,0,011,047,0,0512,64,000,512,010,5,70
3088,0,011,047,0,0414,64,000,512,010,5,70

; ボス 0 - チルノ - 
3400,3,,,,,,,0000,,,0
3400,2,0,,,192,-100,000,000,,,100000
